▞▞▞▞▞▞▞▞▞▞▞▞▞▞▞▞▞▞▞▞▞▞▞▞▞▞▞▞▞▞▞▞▞▞▞▞▞▞▞▞▞▞▞▞▞▞▞▞▞▞▞▞▞▞▞▞▞▞▞▞▞▞▞▞▞▞▞▞▞▞▞▞▞▞▞▞▞▞
▞▞▞▞▞▞▞▞▞▞▞▞▞▞▞▞▞▞▞▞▞▞▞▞▞▞▞▞▞▞▞▞▞▞▞▞▞▞▞▞▞▞▞▞▞▞▞▞▞▞▞▞▞▞▞▞▞▞▞▞▞▞▞▞▞▞▞▞▞▞▞▞▞▞▞▞▞▞
▞▞▞▞                                                                      ▞▞▞▞
▞▞▞▞                                                                      ▞▞▞▞
▞▞▞▞                                                                      ▞▞▞▞
▞▞▞▞                                                                      ▞▞▞▞
▞▞▞▞                                                                      ▞▞▞▞
▞▞▞▞                                                                      ▞▞▞▞
▞▞▞▞                  ██ ▂                                                ▞▞▞▞
▞▞▞▞          ▒▒▓▓    ████      ||     ⋄██  ████████████                  ▞▞▞▞
▞▞▞▞          ▒▒████  ████  ██  ██          ██    ██████                  ▞▞▞▞
▞▞▞▞            ██    ██    ██  ████    ██||        ████                  ▞▞▞▞
▞▞▞▞            ██          ██        ||████ ▂ ⋄██  ||    ||              ▞▞▞▞
▞▞▞▞            ██   ⋄████████  ██████████████  ██      ████   ⊠          ▞▞▞▞
▞▞▞▞            ████        ██  ██          ████████    ████████          ▞▞▞▞
▞▞▞▞                        ██████                ██████████              ▞▞▞▞
▞▞▞▞                                                                      ▞▞▞▞
▞▞▞▞                                                                      ▞▞▞▞
▞▞▞▞                                                                      ▞▞▞▞
▞▞▞▞                                                                      ▞▞▞▞
▞▞▞▞                                                                      ▞▞▞▞
▞▞▞▞                                                                      ▞▞▞▞
▞▞▞▞▞▞▞▞▞▞▞▞▞▞▞▞▞▞▞▞▞▞▞▞▞▞▞▞▞▞▞▞▞▞▞▞▞▞▞▞▞▞▞▞▞▞▞▞▞▞▞▞▞▞▞▞▞▞▞▞▞▞▞▞▞▞▞▞▞▞▞▞▞▞▞▞▞▞
▞▞▞▞▞▞▞▞▞▞▞▞▞▞▞▞▞▞▞▞▞▞▞▞▞▞▞▞▞▞▞▞▞▞▞▞▞▞▞▞▞▞▞▞▞▞▞▞▞▞▞▞▞▞▞▞▞▞▞▞▞▞▞▞▞▞▞▞▞▞▞▞▞▞▞▞▞▞
